00100000000100000000000000001000
00100000000100110000000000000011
00000010000100001000000000100000
00100000000000000000000000000001
00010110011000001111111111111100
