00100000000100000000000000001010
00100000000100010000000000000000
10101100000100000000000000000000
10101100000100010000000000001000
10001100000100100000000000000000
10001100000100110000000000001000
j exit
00100010011100110000000000000001
00001000000000000000000000000110
00100000000101000000000000001001
