00100010000100000000000000001000
00000010001100011000100000100000
00000010001100011000100000100000
00000010001100011000100000100000
00000010001100011000100000100000
00000010000100001000000000100000
00000010000100001000000000100000
