00100000000100000000000000001010
00000000000100001001100000100000
00010010001100000000000000000010
00100010001100010000000000000001
00001000000000000000000000000010
00100000000100100000000000000000
