00100000000100010000000000000010
00010010001000000000000000000001
00100000000100000000000000000001
00100010000100000000000000000010
00100010000100000000000000000011
